  11111111111        111111111111111
11111100001      1111111111111111111
10000111111       101111100000000001
10000000001        101000100000001111
10000010000111111111111000000000001
1000000000000000000000011111111111
100000000000000000000001
100000000000000000000001111111111
100000000001111111110000000000001
100000000001       10000000000001
100000000001       10000000000001
111111011111       11111111111111