WE texture/tonneau.xpm
SO texture/eagle.xpm
EA texture/EA.xpm
NO texture/purplestone.xpm

F255,255,252
C 0,0,00

11111111111111
10000000000001
100E0000000001
10000000000001
10000000000001
10000000000001
10000000001001
10000110000001
10000000001001
10000001000001
10000000000001
11111111111111