WE /home/dcingoz/Downloads/42-cub3d-master/textures/bluestone.xpm
SO /home/dcingoz/Downloads/42-cub3d-master/textures/eagle.xpm
EA /home/dcingoz/Downloads/42-cub3d-master/textures/pillar.xpm
NO /home/dcingoz/Downloads/42-cub3d-master/textures/sky_1.xpm
F255,2,02    
C 0,0,255    
  111111111       11111111111111
11111100001      1111111111111111111
10000111111       101111100000000001
10000000001        10100010000000111
100000100001111 11111111000000000001
10000000000000010000000011111111111
100000000000000000000001
1000000000000001000000001111111111
1000000000011110111110000000000001
100000000001   1   100000000000001
100000000001  101  100000N00000001
111111111111   1   111111111111111