WE /home/bassem/Downloads/Cub3d/texture/WE.xpm
SO /home/bassem/Downloads/Cub3d/texture/SO.xpm
EA /home/bassem/Downloads/Cub3d/texture/EA.xpm
NO /home/bassem/Downloads/Cub3d/texture/NO.xpm

F255,2,02    
C 0,0,255    

11111111111111
10000000000001
10000000000001
10000000000001
10000000000001
10000000000001
10000000001001
10000110000001
10000000001001
100N0001000001
10000000000001
11111111111111