WE /home/dcingoz/CC/cub3d/texture/WE.xpm
SO /home/dcingoz/CC/cub3d/texture/SO.xpm
EA /home/dcingoz/CC/cub3d/texture/EA.xpm
NO /home/dcingoz/CC/cub3d/texture/NO.xpm

F 162,162,162    
C 105,105,105    

11111111111111111111111111111
10000000000000000000000000001
10000000000000000000000000001
10000000000000000000000000001
10000010000000000000000000001
10000001000000000000000000001
10000000100000000000000000001
10000100010000000000000000001
10000000001000000000000000001
10000000000100000000000000001
10000000000010000000000011001
10000000000000000000000000001
10N00000000000000000000000001
11111111111111111111111111111
11111111111111111111111111111