WE /home/dcingoz/Downloads/42-cub3d-master/textures/bluestone.xpm
SO /home/dcingoz/Downloads/42-cub3d-master/textures/eagle.xpm
EA /home/dcingoz/Downloads/42-cub3d-master/textures/pillar.xpm
NO /home/dcingoz/Downloads/42-cub3d-master/textures/sky_1.xpm

F255,2,02    
C 0,0,255    

1111111111111111111111
1000000000000000000001
1000000111100000000001
1000000000000000000001
1000000000000000000001
1000000000000000000001
1000000000000010000001
1000011111110010000001
1000000000N00000000001
1000000010000011000001
1000000000000011000001
1000000000000011000001
1000001111000011000001
1000000000000010000001
1000000000000000000001
1111111111111111111111