WE /home/dcingoz/Downloads/42-cub3d-master/textures/bluestone.xpm
SO /home/dcingoz/Downloads/42-cub3d-master/textures/eagle.xpm
EA /home/dcingoz/Downloads/42-cub3d-master/textures/pillar.xpm
NO /home/dcingoz/Downloads/42-cub3d-master/textures/sky_1.xpm

F255,2,02    
C 0,0,255    

1111111111
1000000001
1000000001
1000000001
1000000001
1000000001
1000N00001
1000000001
1000000001
1111111111