WE ./path_to_the_west_texture
SO ./path_to_the_south_texture
EA ./path_to_the_east_texture
NO ./path_to_the_west_texture

C 225,30,0
F 220,100,0

11111111111        111111111111111
   111100001      1111111111111111111
100000111111       101111100000000001
10000000001        101000100000001111
10000010000111111111111000000000001
1000000000000000000000011111111111
100000000000000000000001
100000000000000000000001111111111
100000000001111111110000000000001
100000000001       10000000000001
100000000001       10000000000001
111111111111       11111111111111
