WE /home/dcingoz/CC/cub3d/texture/WE.xpm
SO /home/dcingoz/CC/cub3d/texture/SO.xpm
EA /home/dcingoz/CC/cub3d/texture/EA.xpm
NO /home/dcingoz/CC/cub3d/texture/NO.xpm

F255,2,02    
C 0,0,255    

11111111111111111111
10000000000000000001
10000000000000000001
100000000000001110001
1000000000N000000001
10000000000011100001
100000111000001110001
10000011100000000011
10000000000000000001
100000000011111100001
10000000000000000001
11111111111111111111