WE texture/tonneau.xpm
SO texture/eagle.xpm
EA texture/EA.xpm
NO texture/purplestone.xpm

F255,255,252    
C 0,0,00    

1111111 111111
10000001000001
10000000000001
10000000000001
 1000000000001
1000000000001 
10000000000001
 10000000000001
10000000000001
100N0000000001
10000001000001
1111111111111