WE/home/dcingoz/CC/cub3d-Extras/texture/greystone.xpm
SO /home/dcingoz/CC/cub3d-Extras/texture/SO.xpm
EA /home/dcingoz/CC/cub3d-Extras/texture/EA.xpm
NO /home/dcingoz/CC/cub3d-Extras/texture/red.xpm

F255,255,252    
C 0,0,00    

1111111 111111
10000001000001
10000000000001  
10000000N00001
 1000000000001  
1000000000001   
1111111111111