WE /home/dcingoz/CC/cub3d-Extras/texture/greystone.xpm
SO /home/dcingoz/CC/cub3d-Extras/texture/SO.xpm
EA /home/dcingoz/CC/cub3d-Extras/texture/eagle.xpm
NO /home/dcingoz/CC/cub3d-Extras/texture/red.xpm

F255,255,252    
C 0,0,00    

1111111111111111111111111
1000000000000000000000001
1000000000001111111110001
1000000000000000000000001
1000000000000000000000001
1000000001111111111110001
1000000000000000000000001
1000000000000000000000101
1000000000000000000000101
100N000000000000000000101
1000000000111111111111101
1111111111111111111111111