WE /home/dcingoz/CC/cub3d-Extras/texture/WE.xpm
SO /home/dcingoz/CC/cub3d-Extras/texture/SO.xpm
EA /home/dcingoz/CC/cub3d-Extras/texture/EA.xpm
NO /home/dcingoz/CC/cub3d-Extras/texture/NO.xpm

F255,255,252    
C 0,0,00    

111111111111111111
100000000000000001
100000000000000001
100000000000000001
100000000000000001
1000000000000000011
1000N00000000000001
10000000000111100111
100000000001  100001
100000000001  100001
100000000001  100001
111111111111  111111