WE texture/tonneau.xpm
SO texture/eagle.xpm
EA texture/EA.xpm
NO texture/purplestone.xpm

F255,255,252    
C 0,0,00    

111111111111111111
100000000000000001
100000000000000001
100000000000000001
1000000000000000011111
1000000000000000000001
1000N00000000000000001
100001111000000111100111
100001  10000001  100001
100001  10000001  100001
100001  10000001  100001
111111  11111111  111111