WE texture/SO.xpm
SO texture/SO.xpm   	
EA texture/SO.xpm
NO texture/SO.xpm

F255,255,252    
C 0,0,00    

1111111111111111111
1001000000000000001
1000000000000000001
1000010000100000001
1000000000000000001
1000000000000000001
1000000000111111111
10000000001
10000000001
10000000001
1000000000111111111
100N000100000000001
1000000000000000001
1111111111111111111